42,8
WWWWWWWWWWWWWWWWWWWWWWWWWWWWWWWWWWWWWWWWWWWWWWWWWWWWWWWWWWWWWWWWWWWWWWWWWMMMMMMMWWWWWWWWWWWWWWWWWWWWWWWWWWWWWWWWWWWWWWWWWWWWWWWW
WWWWWWWWWWWWWWWWWWWWWWWWWWWWWWWWWWWWWWWWWWWWWWWWWWWWWWWWWWWWWWWWWWWWWWWWWMMMMMMMWWWWWWWWWWWWWWWWWWWWWWWWWWWWWWWWWWWWWWWWWWWWWWWW
WWWWWWWWWWWWWWWWWWWWWWWWWWWWWWWWWWWWWWWWWWWWWWWWWWWWWWWWWWWWWWWSWWWWWWWWWMMMMMSMWWWWWWWWWWWWWWWWWWWWWWWWWWWWWWWWWWWWWWWWWWWWWWWW
WWWWWWWWWWWWWWWWWWWWWWWWWWWWWWWWWWWWWWWWWWWWWWWWWWWWWWWWWWWWWWWSSWWWWWWWWSSSMMSSSGWWWWWWWWWWWWWWWWWWWWWWWWWWWWWWWWWWWWWWWWWWWWWW
WWWWWWWWWWWWWWWWWWWWWWWWWWWWWWWWWWWWWWWWWGGWWWWWWWWWWWWWWWWWWWSSSWWWWWWWWSSSSSSSSGGGGWWWWWWWWWWWWWMMMMMMWWWWWWWWWWWWWWWWWWWWWWWW
WWWWWWWWWWWWWWGGGGGGGGWWWWWWWWWWWWWWWWGGGGGGWWWWWWWWWWWGWWWWWWSSSWWWWWWWWWSSSSSSGGGGGGWWWWWWWWWWWWMMMGGMMWWWWWWWWWWWWWWWWWWWWWWW
WWWWWWWWWWWWGGGGGGGGGGGWWWWWWWWGGGGGGGGGGGGGGGWWWWWWWGGGWWWWWWSSSWWWWWWWWWSSSSSSSGGGGGGGGGWWWWWWWMMGGGGGMMMMMMMMWWWWWWWWWWWWWWWW
WWWWWWWWWWWGGGGGGGGGGGGWWWWWGGGGGGGGGGGGGGGGGGGGGGGGGGGGGWWWWSSSSWWWWWWWWWWSSSSSSGGGGGGGGGGGWWWMMGGGGGGGGMMMMMMMMWWWWWWWWWWWWWWW
WWWWWWWWWWWWGGGGGGGGGGGGGGGGGGGGGGGGGGGGGGGGGGGGGGGGGGGGGWWWSSSSSSWWWWWWWWWSSSSSSSGGGGGGGGGGGGGGGGGGGGGGGGGGMMMMMMWWWWWWWWWWWWWW
WWWWWWWWWWWWGGGGGGGGGGGGGGGGGGGGGGGGGGGGGGGGGGGGGGGGGGGGGWWWGSSSSSSSWWWWWWWWSSSSSSGGGGGGGGGGGGGGGGGGGGGGGGGGGGMMMMMWWWWWWWWWWWWW
WWWWWWWWWWWWWWWGGGGGGGGGGGGGGGGGGGGGGGGGGGGGGGGGGGGGGGGGGGGGGGSSSSSSSWWWWWWWSSSSSSSGGGGGGGGGGGGGGGGGGGGGGGGGGGMMMMMWWWWWWWWWWWWW
WWWWWWWWWWWWWWWWGGGGGGGGGGGGGGGGGGGGGGGGGGGGGGGGGGGGGGGGGGGGGGSSSSSSSSWWWWWWWSSSSSSGGGGGGGGGGGGGGGGGGGGGGGGGGGGMMWWWWWWWWWWWWWWW
WWWWWWWWWWWWWWWWGGGGGGGGGGGGGGGGGGGGGGGGGGGGGGGGGGGGGGGGGGGGGGGSSSSSSSWWWWWWWSSSSSSSGGGGGGGGGGGGGGGGGGGGGGGGGGGMWWWWWWWWWWWWWWWW
WWWWWWWWWWWWWWWWGGGGGGGGGGGGGGGGGGGGGGGGGGGGGGGGGGGGGGGGGGGGGGGSSSSSSSSWWWWWWWSSSSSSGGGGGGGGGGGGGGGGGGGGGGGGGWWWWWWWWWWWWWWWWWWW
WWWWWWWWWWWWWWWGGGGGGGGGGGGGGGGGGGGGGGGGGGGGGGGGGGGGGGGGGGGGGGSSSSSSSSSSWWWWWWSSSSSSGGGGGGGGGGGGGGGGGGGGGGGGWWWWWWWWWWWWWWWWWWWW
WWWWWWWWWWWWWWWGGGGGGGGGGGGGGGGGGGGGGGGGGGGGGGGGGGGGGGGGGGGGGGSSSSSSSSSSWWWWWWSSSSSSGGGGGGGGGGGGGGGGGGGGGGGGWWWWWWWWWWWWWWWWWWWW
WWWWWWWWWWGWWWGGGGGGGGGGGGGGGGGGGGGGGGGGGGGGGGGGGGGGGGGGGGGGGSSSSSSSSSSSWWWWWWWSSSSSSGGGGGGGGGGGGGGGGGGGGGGGGWWWWWWWWWWWWWWWWWWW
WWWWWWWWGGGWWGGGGGGGGGGGGGGGGGGGGGGGGGGGGGGGGGGGGGGGGGGGGGGGSSSSSSSSSSSSWWWWWWWSSSSSSSGGGGGGGGGGGGGGGGGGGGGGGWWWWWWWWWWWWWWWWWWW
WWWWWWGGGGGGGMMMMMMMMMMGGGGGGGMMMMMMMMMMMMMMMGGGGGGGMMMMMMMMMMSSSSSSSSSSWWWWWWWWSSSSSSGGGGGGGGGGGGGGGGGGGGGGGGGGGGGGGGWWWWWWWWWW
WWWWGGGGGGGGGMGGGGGGMGMGGGGGGGMGMGGGGGGGGGMGMGGGGGGGMGMGGGGGGMSSSSSSSSSSWWWWWWWWSSSSSSSGGGGGGGGGGGGGGGGGGGGGGGGGGGGGGGGWWWWWWWWW
WWWWGGGGGGGGGMGGGGGGMGGMMMMMMMGGMGGGGGGGGGMGGMMMMMMMGGMGGGGGGMSSSSSSSSSSWWWWWWWWWSSSSSSGGGGGGGGGGGGGGGGGGGGGGGGGGGGGGGGGWWWWWWWW
WWWWGGGGGGGGGMGGGGGGGGGGGGGGGGGGMGGGGGGGGGMGGGGGGGGGGGGGGGGGGMSSSSSSSSSWWWWWWWWWWSSSSSSGGGGGGGGGGGGGGGGGGGGGGGGGGGGGGGGGGWWWWWWW
WWWWWGGGGGGGGMGGGGGGGGGGGGGGGGGGMGGGGGGGGGMGGGGGGGGGGGGGGGGGGMSSSSSSSSSWWWWWWWWWWSSSSSSGGGGGGGGGGGGGGGGGGGGGGGGGGGGGGGGGGWWWWWWW
WWWWWGGGGGGGGMGGGGGGMGGGGGGGGGGGMGGGGGGGGGMGGGGGGGGGGGMGGGGGGMSSSSSSSSWWWWWWWWWWWSSSSSSGGGGGGGGGGGGGGGGGGGGGGGGGGGGGGGGGGGWWWWWW
WWWWWGGGGGGGGMGGGGGGMGGGGGGGGGGGMGGGGGGGGGMGGGGGGGGGGGMGGGGGGMSSSSSSSSWWWWWWWWWWWSSSSSGGGGGGGGGGGGGGGGGGGGGGGGGGGGGGGGGGGGWWWWWW
WWWWWGGGGGGGGMMMMMMMMMMMMMMMGGGGMGGGGGGGGGMGGGGMMMMMMMMMMMMMMMSSSSSSSWWWWWWWWWWWSSSSSSGGGGGGGGGGGGGGGGGGGGGGGGGGGGGGGGGGGGWWWWWW
WWWWWWGGGGGGGMGGGGGGMGGGGGGMGGGGMGGGGGGGGGMGGGGMGGGGGGMGGGGGGMSSSSSSWWWWWWWWWWWSSSSSSSGGGGGGGGMMGGGGGGGGGGGGGGGGGGGGGGGGGWWWWWWW
WWWWWWGGGGGGGMGGGGGGMGGGGGGMGGGGMGGGGGGGGGMGGGGMGGGGGGMGGGGGGMSSSSSSWWWWWWWWWWSSSSSSSGGGGGGGGMMMMGGGGGGGGGGGGGGGGGGGGGGGGWWWWWWW
WWWWWGGGGGGGGGMGGGGGMGGGGGGMGGGGMGGGGGGGGGMGGGGMGGGGGGMGGGGGMGSSSSSSWWWWWWWWWSSSSSSSSGGGGGGGGMMMMMGGGGGGGGGGGGGGGGGGGGGGGGWWWWWW
WWWWGGGGGGGGGGGMGGGGMGGGGGGGGGGGMGGGGGGGGGMGGGGGGGGGGGMGGGGMGGSSSSSSWWWWWWWWSSSSSSSSGGGGGGGGMMMMMMGGGGGGGGGGGGGGGGGGGGGGGGGGWWWW
WWWWGGGGGGGGGGGMGGGGMGGGGGGGGGGGMGGGGGGGGGMGGGGGGGGGGGMGGGGMGGSSSSSSWWWWWWSSSSSSSSSGGGGGGGGGGMMMMMGGGGGGGGGGGGGGGGGGGGGGGGGGWWWW
WWWWGGGGGGGGGGGMGGGGMGGGGGGMGGGGMGGGGGGGGGMGGGGMGGGGGGMGGGGMGGSSSSSSWWWWWWSSSSSSSSGGGGGGGGGGGGMMGGGGGGGGGGGGGGGGGGGGGGGGGGGGGWWW
WWWWGGGGGGGGGGGMGGGGMMMMMMMMGGGGGGGGGGGGGGGGGGGMMMMMMMMGGGGMGGSSSSSSWWWWWWSSSSSSSSGGGGGGGGGGGGGGGGGGGGGGGGGGGGGGGGGGGGGGGGGGWWWW
WWWWGGGGGGGGGGGMGGGGGGGGGGGGGGGGGGGGGGGGGGGGGGGGGGGGGGGGGGGMGGSSSSSWWWWWWWSSSSSSSSGGGGGGGGGGGGGGGGGGGGGGGGGGGGGGGGGGGGGGGGGGWWWW
WWWWGGGGGGGGGGGMGGGGMMMMMMMMGGGGGGGGGGGGGGGGGGGMMMMMMMMGGGGMGGSSSSWWWWWWWWSSSSSSSSSGGGGGGGGGGGGGGGGGGGGGGGGGGGGGGGGGGGGGGGWWWWWW
WWWWGGGGGGGGGGGMGGGGMGGGGGGMGGGGMGGGGGGGGGMGGGGMGGGGGGMGGGGMGGGSSSWWWWWWWWWSSSSSSSSSGGGGGGGGGGGGGGGGGGGGGGGGGGGGGGGGGGGGWWWWWWWW
WWWWGGGGGGGGGGGMGGGGMGGGGGGGGGGGMGGGGGGGGGMGGGGGGGGGGGMGGGGMGGGSSSWWWWWWWWWSSSSSSSSSGGGGGGGGGGGGGGGGGGGGGGGGGGGGGGGGGGWWWWWWWWWW
WWWWGGGGGGGGGGGMGGGGMGGGGGGGGGGGMGGGGGGGGGMGGGGGGGGGGGMGGGGMGGSSSSSWWWWWWWWWWSSSSSSSSGGGGGGGGGGGGGGGGGGGGGGGGGGGGGGGGWWWWWWWWWWW
WWWWGGGGGGGGGGMGGGGGMGGGGGGMGGGGMGGGGGGGGGMGGGGMGGGGGGMGGGGGMGSSSSSSWWWWWWWWWWWSSSSSSSGGGGGGGGGGGGGGGGGGGGGGGGGGGGGGWWWWWWWWWWWW
WWWWGGGGGGGGGMGGGGGGMGGGGGGMGGGGMGGGGGGGGGMGGGGMGGGGGGMGGGGGGMSSSSSSSSWWWWWWWWWWWSSSSSSSGGGGGGGGGGGGGGGGGGGGGGGGGGGGWWWWWWWWWWWW
WWWWGGGGGGGGGMGGGGGGMGGGGGGMGGGGMGGGGGGGGGMGGGGMGGGGGGMGGGGGGMSSSSSSSSSWWWWWWWWWWWSSSSSSSGGGGGGGGGGGGGGGGGGGGGGGGGGGWWWWWWWGGWWW
WWWWWGGGGGGGGMMMMMMMMMMMMMMMMMMMMGGGGGGGGGMMMMMMMMMMMMMMMMMMMMGMMMSSSSSSSWWWWWWWWWWSSSSSSGGGGGGGGGGGGGGGGGGGGGGGGGGWWWWWWWGGGWWW
WWWWWWWWGGGGGMGGGGGGMGGGGGGGGGGGMGGGGGGGGGMGGGGGGGGGGGMGGGGGGMGMMMMMSSSSSSWWWWWWWWWWSSSSSGGGGGGGGGGGGGGGGGGGGGGGGGGGGGGGMGGGGWWW
WWWWWWWWGGGGGMGGGGGGMGGGGGGGGGGGMGGGGGGGGGMGGGGGGGGGGGMGGGGGGMGMMMMMMMSSSSSWWWWWWWWWWSSSSSGGGGGGGGGGGGGGGGGGGGGGGGGGGGGGMMGGGWWW
WWWWWWWWGGGGGMGGGGGGMGGGGGGGGGGGMGGGGGGGGGMGGGGGGGGGGGMGGGGGGMGMMMMMMMSSSSSSWWWWWWWWWSSSSSGGGGGGGGGGGGGGGGGGGGGGGGGGGGGGGMMGWWWW
WWWWWWWWGGGGGMGGGGGGMGGGGGGGGGGGMGGGGGGGGGMGGGGGGGGGGGMGGGGGGMGMMMMMMMSSSSSSWWWWWWWWWSSSSSSGGGGGGGGGGGGGGGGGGGGGGGGGGGGGGGMMWWWW
WWWWWWWWWGGGGMGGGGGGMGGGGGGGGGGGMGGGGGGGGGMGGGGGGGGGGGMGGGGGGMGMMGMMMSSSSSSWWWWWWWWWWWSSSSSGGGGGGGGGGGGGGGGGGGGGGGGGGGGGGGGGGWWW
WWWWWWWWWWGGGMGGGGGGMGGGGGGGGGGGMGGGGGGGGGMGGGGGGGGGGGMGGGGGGMGGGSSSSSSSSSSWWWWWWWWWWWSSSSSGGGGGGGGGGGGGGGGGGGGGGGGGGGGGGGGGWWWW
WWWWWWWWWWGGGMMMMMMMMGGGGGGGGGGGMMMGGGGGMMMGGGGGGGGGGGMMMMMMMMGGGSSSSSSSSSWWWWWWWWWWWWSSSSSGGGGGGGGMMMMGGGGGGGGGGGGGGGGGGGWWWWWW
WWWWWWWWWGGGGGGGGGGGGGGGGGGGGGGGGGGGGGGGGGGGGGGGGGGGGGGGGGGGGGGGGGGSSSSSSWWWWWWWWWWWWWSSSSSGGGGGGGGMMMMMGGGGGGGGGGGGGGGGGGWWWWWW
WWWWWWWWWGGGGGGGGGGGGGGGGGGGGGGGGGGGGGGGGGGGGGGGGGGGGGGGGGGGGGGGGGSSSSSSWWWWWWWWWWWWWSSSSSSGGGGGGGMMMMMMMMGGGGGGGGGGGGGGGGWWWWWW
WWWWWWWGGGGGGGGGGGGGGGGGGGGGGGGGGGGGGGGGGGGGGGGGGGGGGGGGGGGGGGGGGSSSSSSWWWWWWWWWWWWWSSSSSSGGGGGGGGGMMMMMMMGGGGGGGGGGGGGGGGWWWWWW
WWWWWGGGGGGGGGGGGGGGGGGGGGGGGGGGGGGGGGGGGGGGGGGGGGGGGGGGGGGGGGGGSSSSSSWWWWWWWWWWWWWSSSSSSSGGGGGGGGGGMMMMMMMMMGGGGGGGGGGGGGWWWWWW
WWWWWGGGGGGGGGGGGGGGGGGGGGGGGGGGGGGGGGGGGGGGGGGGGGGGGGGGGGGGGGGSSSSSSWWWWWWWWWWWWWWSSSSSSGGGGGGGGGGGGSMMMMMMMGGGGGGGGGGGGGGWWWWW
WWWWGGGGGGGGGGGGGGGGGGGGGGGGGGGGGGGGGGGGGGGGGGGGGGGGGGGGGGGGGGSSSSSSWWWWWWWWWWWWWWWSSSSSSGGGGGGGGGGGGSWWMMMMMGGGGGGGGGGGGGGWWWWW
WWWWGGGGGGGGGGGGGGGGGGGGGGGGGGGGGGGGGGGGGGGGGGGGGGGGGGGGGGGGGSSSSSSWWWWWWWWWWWWWWWSSSSSSSGGGGGGGGGGGGSWWWWMMMMMMGGGGGGGGGGGGGWWW
WWWWWGGGGGGGGGGGGGGGGGGGGGGGGGGGGGGGGGGGGGGGGGGGGGGGGGGGGGSSSSSSWWWWWWWWWWWWWWWWWSSSSSSSGGGGGGGGGGGGGSSWWWWMMMMMMGGGGGGGGGGGGWWW
WWWWWWGGGGGGGGGGGGGGGGGGGGGGGGGGGGGGGGGGGGGGGGGGGGGGGGGGGGSSSSSWWWWWWWWWWWWWWWWWSSSSSSGGGGGGGGGGGGGGGGSSWWWWWMMMMGGGGGGGGGGGGWWW
WWWWWWWGGGGGGGGGGGGGGGGGGGGGGGGGGGGGGGGGGGGGGGGGGGGGGGGGGSSSSSSWWWWWWWWWWWWWWWWSSSSSSGGGGGGGGGGGGGGGGGGSWWWWWMMMMMMMGGGGGGGGWWWW
WWWWWWWGGGGGGGGGGGGGGGGGGGGGGGGGGGGGGGGGGGGGGGGGGGGGGGGGSSSSSSSWWWWWWWWWWWWWWWSSSSSSSGGGMGGGGGGGGGGGGGGSWWWWWWWMMMMMGGGGGGWWWWWW
WWWWWWGGGGGGGGGGGGGGGGGGGGGGGGGGGGGGGGGGGGGGGGGGGGGGGGGSSSSSSSSWWWWWWWWWWWWWWWSSSSSSGGGMMMGGGGGGGGGGGGGSSSWWWWWWMMMMMMGGGGWWWWWW
WWWWWWGGGGGGGGGGGGGGGGGGGGGGGGGGGGGGGGGGGGGGGGGGGGGGGGSSSSSSSSSWWWWWWWWWWWWWWSSSSSSSGGGMMMGGGGGGGGGGGGGGGSSSWWWWWWMMMMMGGWWWWWWW
WWWWWGGGGGGGGGGGGGGGGGGGGGGGGGGGGGGGGGGGGGGGGGGGGGGGGGSSSSSSSSWWWWWWWWWWWWWWSSSSSSSSGGGMMMGGGGGGGGGGGGGGGGGSSSSSSSSGMMMGGWWWWWWW
WWWWWGGGGGGGGGGGGGGGGGGGGGGGGGGGGGGGGGGGGGGGGGGGGGGGGSSSSSSSSWWWWWWWWWWWWSSSSSSSSSSGGGGGMGGGGGGGGGGGGGGGGGGGGGGGGGGGGGGGGGWWWWWW
WWWWWGGGGGGGGGGGGGGGGGGGGGGGGGGGGGGGGGGGGGGGGGGGGGGGSSSSSSSWWWWWWWWWWWSSSSSSSSSSSSSGGGGGGGGGGGGGGGGGGGGGGGGGGGGGGGGGGGGGGGGGWWWW
WWWWWGGGGGGGGGGGGGGGGGGGGGGGGGGGGGGGGGGGGGGGGGGGGGGSSSSSSSWWWWWWWWWWWSSSSSSSSSSSGGGGGGGGGGGGGGGGGGGGGGGGGGGGGGGGGGGGGGGGGGGGWWWW
WWWWWGGGGGGGGGGGGGGGGGGGGGGGGGGGGGGGGGGGGGGGGGGGGGGSSSSSSWWWWWWWWWWWSSSSSSSSSSGGGGGGGGGGGGGGGGGGGGGGGGGGGGGGGGGGGGGGGGGGGGGGWWWW
WWWWWWGGGGGGGGGWWWWWWGGGGGGGGGGGGGGGGGGGGGGGGGGGGGGSSSSSSWWWWWWWWWWWSSSSSSSSSGGGGGGGGGGGGGGGGGGGGGGGGGGGGGGGGGGGGGGGGGGGGGGGWWWW
WWWWWWWWGGGWWWWWWWWWWWWGGGGGGGGGGGGGGGGGGGGGGGGGGGGSSSSSWWWWWWWWWWWWSSSSSSSSGGGGGGGGGGGGGGGGGGGGGGGGGGGGGGGGGGGGGGGGGGGGGGGGWWWW
WWWWWWWWWWWWWWWWWWWWWWWGGGGGGGGGGGGGGGGGGGGGGGGGGGGSSSSWWWWWWWWWWWWWSSSSSGGGGGGGGGGGGGGGGGGGGGGGGGGGGGGGGGGGGGGGGGGGGGGGGGWWWWWW
WWWWWWWWWWWWWWWWWWWWWWGGGGGGGGGGGGGGGGGGGGGGGGGGGGGSSSSWWWWWWWWWWWWWSSSSGGGGGGGGGGGGGGGGGGGGGGGGGGGGGGGGGGGGGGGGGGGGGGGGWWWWWWWW
WWWWWWWWWWWWWWWWGGGGGGGGGGGGGGGGGGGGGGGGGGGGGGGGGGGGSSSWWWWWWWWWWWWWSSSSSGGGGGGGGGGGGGGGGGGGGGGGGGGGGGGGGGGGGGGGGGGGGGGWWWWWWWWW
WWWWWWWWWWWWWWWGGGGGGGGGGGGGGGGGGGGGGGGGGGGGGGGGGGGSSSSWWWWWWWWWWWWWWSSSSGGGGGGGGGGGGGGGGGGGGGGGGGGGGGGGGGGGGGGGGGGGGGGWWWWWWWWW
WWWWWWWWWWWWWWGGGGGGGGGGGGGGGGGGGGGGGGGGGGGGGGGGGGGSSSSWWWWWWWWWWWWWWSSSSGGGGGGGGGGGGGGGGGGGGGGGGGGGGGGGGGGGGGGGGGGGGGGWWWWWWWWW
WWWWWWWWWWWWWGGGGGGGGGGGGGGGGGGGGGGGGGGGGGGGGGGGGGGSSSSWWWWWWWWWWWWWSSSSSGGGGGGGGGGGGGGGGGGGGGGGGGGGGGGGGGGGGGGGGGGGGGGGWWWWWWWW
WWWWWWWWWWWWWGGGGGGGGGGGGGGGGGGGGGGGGGGGGGGGGGGGGGSSSSSWWWWWWWWWWWSSSSSSSGGGGGGGGGGGGGGGGGGGGGGGGGGGGGGGGGGGGGGGGGGGGGGGGGGWWWWW
WWWWWWWWWWWWWGGGGGGGGGGGGGGGGGGGGGGGGGGGGGGGGGGGGGSMMSSMWWMWWMWWMSSMSSMMGGGGGGGGGGGGGGGGGGGGGGGGGGGGGGGGGGGGGGGGGGGGGGGGGGGWWWWW
WWWWWWWWWWWWWGGGGGGGGGGGGGGGGGGGGGGGGGGGGGGGGGGGGGMMMMMMMMMMMMMMMMMMMMMMMGGGGGGGGGGGGGGGGGGGGGGGGGGGGGGGGGGGGGGGGGGGGGGGGGGWWWWW
WWWWWWWWWWWWWGGGGGGGGGGGGGGGGGGGGGGGGGGGGGGGGGGGGGGGGGGGGGGGGGGGGGGGGGGGGGGGGGGGGGGGGGGGGGGGGGGGGGGGGGGGGGGGGGGGGGGGGGGGGGGWWWWW
WWWWWWWWWWWWWGGGGGGGGGGGGGGGGGGGGGGGGGGGGGGGGGGGGGGGGGGGGGGGGGGGGGGGGGGGGGGGGGGGGGGGGGGGGGGGGGGGGGGGGGGGGGGGGGGGGGGGGGGGGGWWWWWW
WWWWWWWWWWWWWGGGGGGGGGGGGGGGGGGGGGGGGGGGGGGGGGGGGGGGGGGGGGGGGGGGGGGGGGGGGGGGGGGGGGGGGGGGGGGGGGGGGGGGGGGGGGGGGGGGGGGGGGGGMMMMMMMM
WWWWWWWWWWWWWWGGGGGGGGGGGGGGGGGGGGGGGGGGGGGGGGGGGGGGGGGGGGGGGGGGGGGGGGGGGGGGGGGGGGGGGGGGGGGGGGGGGGGGGGGGGGGGGGGGGGGGGGMGMMMMMMMM
WWWWWWWWWWWWWWWGGGGGGGGGGGGGGGGGGGGGGGGGGGGGGGGGGGMMMMMMMMMMMMMMMMMMMMMMMGGGGGGGGGGGGGGGGGGGGGGGGGGGGGGGGGGGGGGGGGGGGMMGWWWWWWMM
WWWWWWWWWWWWWWWWWGGGGGGGGGGGGGGGGGGGGGGGGGGGGGGGGGGMMGSMSSMWWMWWMWWMSSMMGGGGGGGGGGGGGGGGGGGGGGGGGGGGGGGGGGGGGGGGGGGGGMMGGGWWWWMM
WWWWWWWWWWWWWWWWWWGGGGGGGGGGGGGGGGGGGGGGGGGGGGGGGGGGGSSSSSWWWWWWWWWWSSSSSSGGGGGGGGGGGGGGGGGGGGGGGGGGGGGGGGGGGGGGGGGGGMMGGGGGWWMM
WWWWWWWWWWWWWWWWWWWWGGGGGGGGGGGGGGGGGGGGGGGGGGGGGGGGSSSSSSWWWWWWWWWWSSSSSSGGGGGGGGGGGGGGGGGGGGGGGGGGGGGGGGGGGGGGGGGGMMGGGGGGGWMM
WWWWWWWWWWWWWWWWWWWWGGGGGGGGGGGGGGGGGGGGGGGGGGGGGGGSSSSSSWWWWWWWWWWWWSSSSSGGGGGGGGGGGGGGGGGGGGGGGGGGGGGGGGGGGGGGGWWWMMGGGGGGGWMM
WWWWWWWWWWWWWWWWWWWGGGGGGGGGGGGGGGGGGGGGGGGGGGGGGGGSSSSSWWWWWWWWWWWWWSSSSSGGGGGGGGGGGGGGGGGGGGGGGGGGGGGGGGGGGGGGWWWWMMGGGGGGWMMM
WWWWWWWWWWWWWWWWWWWGGGGGGGGGGGGGGGGGGGGGGGGGGGGGGGGSSSSWWWWWWWWWWWWWWSSSSSGGGGGGGGGGGGGGGGGGGGGGGGGGGGGGGGGGGGGWWWWWMMMMGGMMMMMW
WWWWWWWWWWWWWWWWWWGGGGGGGGGGGGGGGGGGGGGGGGGGGGGGGGGSSSSWWWWWWWWWWWWWWSSSSSGGGGGGGGGGGGGGGGGGGGGGGGGGGGGGGGGGGGGWWWWWWMMMMMMMMMWW
WWWWWWWWWWWWWWWWWGGGGGGGGGGGGGGGGGGGGGGGGGGGGGGGGGGGSSSSWWWWWWWWWWWWSSSSSSGGGGGGGGGGGGGGGGGGGGGGGMGGGGGGGGGGGGGWWWWWWWWWMMWWWWWW
WWWWWWWWWWWWWWWWWGGGGGGGGGGGGGGGGGGGGGGGGGGGGGGGGGGGGSSSWWWWWWWWWWWWSSSSSGGGGGGGGGGGGGGGGGGGGGGGMMMGGGGGGGGGGGGGGGGGGWWWWWWWWWWW
WWWWWWWWWWWWWWWWMMMGGGGGGGGGGGGGGGGGGGGGGGGGGGGGGGGGGSSSSWWWWWWWWWWSSSSSSGGGGGGGGGGGGGGGGGGGGGGGMMMGGGGGGGGGGGGGGGGGGGGWWWWWWWWW
WWWWWWWWWWWWWWWMMMMGGGGMMMGMMMGMMMGGMGMMMGGGGGGGGGGGGSSSSWWWWWWWWWWSSSSSSGGGGGGGGGGGGGGGGGGGGGGMMMMMGGGGGGGGGGGGGGGGGGGWWWWWWWWW
WWWWWWWWWWWWMMMMMMMGGGGMGGGGMGGGGMGGMGGGMGGGGGGGGGGGGSSSSSWWWWWWWWSSSSSSSSGGGGGGGGGGGGGGGGGGGGGGMMMGGGGGGGGGGGGGGGGGGGGGGGWWWWWW
WWWWWWWWWWWWMMMMMMGGGGGMGGGGMGGGGMGGMGGGMGGGGGGGGGGGGGSSSSWWWWWWWWSSSSSSSSGGGGGGGGGGGGGGGGGGGGGGGMGGGGGGGGGGGGGGGGGGGGGGGGWWWWWW
WWWWWWWWWWMMMGMMMGGGGGGMMMMMMMMMMMGGMGGGMGGGGGGGGGGGGGGSSSSWWWWWWWSSSSSSSGGGGGGGGGGGGGGGGGGGGGGGGGGGGGGGGGGGGGGGGGGGGGGGGWWWWWWW
WWWWWWWWWWMMMMMMGGGGGGGGGGMGGGMGGGGGMGGGMGGGGGGGGGGGGGGSSSSWWWWWWSSSSSSSSGGGGGGGGGGGGGGGGGGGGGGGGGGGGGGGGGGGGGGGGGGGGGGGWWWWWWWW
WWWWWWWWWMMMMMGGGGGGGGGGGGMGGGMGMMMMMMMMMGGGGGGGGGGGGGSSSSSWWWWWWSSSSSSSSGGGGGGGGGGGGGGGGGGGGGGGGGGGGGGGGGGGGGGGGGGGGGGGWWWWWWWW
WWWWWWWWWMMMMMGGGGGGGGGGGGMGGGMGMGGGGGGGMGGGGGGGGGGGGGSSSSWWWWWWWSSSSSSSSGGGGGGGGGGGGGGGGGGGGGGGGGGGGGGGGGGGGGGGGGGGGGGWWWWWWWWW
WWWWWWWWMMMMMMMMGGGGGGGGGGMGGGMGMGGGGGGGMGGGGGGGGGGGGGSSSSWWWWWWWWSSSSSSSGGGGGGGGGGGGGGGGGGGGGGGGGGGGGGGGGGGGGGGGGGGGGGWWWWWWWWW
WWWWWWWWMMMMMMMMMGGGGGGGGGMMGMMGMMMGMMMMMGGGGGGGGGGGGSSSSWWWWWWWWWSSSSSSSGGGGGGGGGGGGGGGGGGGGGGGGGGGGGGGGGGGGGGGGGGGGGGGWWWWWWWW
WWWWWWWWWWWWMMMMMGGGGGGGGGGGGGGGGGGGGGGGGGGGGGGGGGGGGSSSSWWWWWWWWWWSSSSSSGGGGGGGGGGGGGGGGGGGGGGGGGGGGGGGGGGGGGGGGGGGGGGGWWWWWWWW
WWWWWWWWWWWWWMMMMGGGGGGGGGGGGGGGGGGGGGGGGGGGGGGGGGGGGSSSSWWWWWWWWWWSSSSSSSGGGGGGGGGGGGGGGGGGGGGGGGGGGGGGGGGGGGGGGGGGGGGGGWWWWWWW
WWWWWWWWWWWWWMMMMGGGGGGGGGGGGGGGGGGGGGGGGGGGGGGGGGGGGSSSSSWWWWWWWWWWSSSSSSSSGGGGGGGGGGGGGGGGGGGGGGGGGGGGGGGGGGGGGGGGGWGGGGWWWWWW
WWWWWWWWWWWWWMMMMGGGGGGGGGGGGGGGGGGGGGGGGGGGGGGGGGGGGSSSSSWWWWWWWWWWWSSSSSSSSGGGGGGGGGGGGGGGGGGGGGGGGGGGGGGGGGGGGGGGWWWGGGGWWWWW
WWWWWWWWWWWWWMMMGGGGGGGGGGGGGGGGGGGGGGGGGGGGGGGGGGGGGSSSSSSWWWWWWWWWWWSSSSSSSSGGGGGGGGGGGGGGGGGGGGGGGGGGGGGGGGGGGGGWWWWGGGWWWWWW
WWWWWWWWWWWWWMMMGGGGGGGGGGGGGGGGGGGGGGGGGGGGGGGGGGGGGSSSSSSWWWWWWWWWWWWSSSSSSSGGGGGGGGGGGGGGGGGGGGGGGGGGGGGGGGGGGGWWWWWWWWWWWWWW
WWWWWWWWWWWWMMMMMGGGGGGGGGGGGGGMGGGGGGGGGGGGGGGGGGGGGGSSSSSSWWWWWWWWWWWSSSSSSSGGGGGGGGGGGGGGGGGGGGGGGGGGGGGGGGGGGGWWWWWWWWWWWWWW
WWWWWWWWWWMMMMMMMGGGGGGGGGGGGGMMGGGGGGGGGGGGGGGGGGGGGGGSSSSSWWWWWWWWWWWWSSSSSSGGGGGGGGGGGGGGGGGGGGGGGGGGGGGGGGGGGWWWWWWWWWWWWWWW
WWWWWWWWWWMMMMMMMGGGGGGGGGGGGGMMMMGGGGGGGGGGGGGGGGGGGGGGSSSSSWWWWWWWWWWWWSSSSSSGGGGGGGGGGGGGGGGGGGGGMMGGGGGMMGGGGWWWWWWWWWWWWWWW
WWWWWWWWWMMMMMMGGGGGGGGGGGGGGMMMMMGGGGGGGGGGGGGGGGGGGGGGGSSSSSWWWWWWWWWWWSSSSSSGGGGGGGGGGGGGGGGGGGGGMMGGGGGMMGGGGWWWWWWWWWWWWWWW
WWWWWWWWWMMMMMGGGGGGGGGGGGGGGMMMMMGGGGGGGGGGGGGGGGGGGGGGGSSSSSSWWWWWWWWWWSSSSSSSGGGGGGGGGGGGGGGGGGGGMMGGGGGMMGGGWWWWWWWWWWWWWWWW
WWWWWWWWWMMMMGGGGGGGGGGGGGGGMMMMMMGGGGGGGGGGGGGGGGGGGGGGGSSSSSSSWWWWWWWWWSSSSSSSSGGGGGGGGGGWGGGGGGGGMMGGGGGMMGGGWWWWWWWWWWWWWWWW
WWWWWWWWMMMMMMMGGGGGGGGGGGGGMMMMMMMGGGGGGGGGGGGGGGGGGGGGGSSSSSSSSSWWWWWWWWWWSSSSSGGGGGGGGWWWGGGGGGGGMMGGGGGMMGGGWWWWWWWWWWWWWWWW
WWWWWWWWWMMMMMMGGGMMGGGGGGGMMMMMMMMMGGGGMMMGGGGGGGGGGGGGSSSSSSSSSSSWWWWWWWWWSSSSSSGGGGGGWWWWGGGGGGGGMMGGGGGMMGWWWWWWWWWWWWWWWWWW
WWWWWWWWMMMMMMMMMMMMMGGGGGGMMMMMMMMGGGGMMGMMMGGGGGGGGGGGSSSSSSSSSSWWWWWWWWWWSSSSSSGGGGWWWWWWWGGGGGGGMMGGGGGMMWWWWWWWWWWWWWWWWWWW
WWWWWWWMMMMMMMMMMMMMMMMMMGGMMMMMMMMGGGGMMMMMMMGGGGGGGGGGSSSSSSSSSSWWWWWWWWWWSSSSSGGGGWWWWWWWWWWWWWWWMMGGGGGMMWWWWWWWWWWWWWWWWWWW
WWWWWWWMMMWMMMMMMMMMMMMMMMMMMMMMMMMGGGMMMMMMMMGMMGGGGWWWWSSSSSSSSSWWWWWWWWWWSSSSSGGGWWWWWWWWWWWWWWWWMMGGGGGMMWWWWWWWWWWWWWWWWWWW
WWWWWWWMMMWMMMMMMMMMMMMMMMMMMMMMMMMMMMMMMMMMMMMMMMGGWWWWWWSSSSSSSSWWWWWWSSSSSSSSSGGWWWWWWWWWWWWWWWWWMMGGGGGMMWWWWWWWWWWWWWWWWWWW
WWWWWWWWMWWWMMMMMMMMMMMMMMMMMMMMMMMMMMMMMMMMMMMMMMMMWWWWWWSSSSSSSSWWWWWWSSSSSSSSSGWWWWWWWWWWWWWWWWWWMMGGGGGMMWWWWWWWWWWWWWWWWWWW
WWWWWWWWWWWWMMMMMMMMMMMMMMMMMMMMMMMMMMMMMMMMMMMMMMMMWWWWWWWSSSSSSWWWWWWWMSSSSSSSSWWWWWWWWWWWWWWWWWWWMMGGGGGMMWWWWWWWWWWWWWWWWWWW
WWWWWWWWWWWWMMMMMMMMMMMMMMMMMMMMMMMMMMMMMMMMMMMMMMMMWWWWWWWSSSSSWWWWWWWWMMSSSSSSWWWWWWWWWWWWWWWWWWWWMMMMMMMMMWWWWWWWWWWWWWWWWWWW
WWWWWWWWWWWWMMMMMMMMMMMMMMMMMMMMMMMMMMMMMMMMMMMMMMMWWWWWWWWWWWWWWWWWWWWMMMMMMSSSWWWWWWWWWWWWWWWWWWWWWWWWWWWWWWWWWWWWWWWWWWWWWWWW
WWWWWWWWWWWWMMMMMMMMMMMMMMMMMMMMMMMMMMMMMMMMMMMMMMMMWWWWWWWWWWWWWWWWWWWMMMMMMWWWWWWWWWWWWWWWWWWWWWWWWWWWWWWWWWWWWWWWWWWWWWWWWWWW
WWWWWWWWWWWMMMMMMMMMMMMMMMMMMMMMMMMMMMMMMMMMMMMMMMMMMWWWWWWWWWWWWWWWWWMMMMMMMMWWWWWWWWWWWWWWWWWWWWWWWWWWWWWWWWWWWWWWWWWWWWWWWWWW
WWWWWWWWWWWMMMMMMMMMMMMMMMMMMMMMMMMMMMMMMMMMMMMMMMMMMWWWWWWWWWWWWWWWWWMMMMMMMMWWWWWWWWWWWWWWWWWWWWWWWWWWWWWWWWWWWWWWWWWWWWWWWWWW
WWWWWWWWWWMMMMMMMMMMMMMMMMMMMMMMMMMMMMMMMMMMMMMMMMMMMMWWWWWWWWWWWWWWWMMMMMMMMMWWWWWWWWWWWWWWWWWWWWWWWWWWWWWWWWWWWWWWWWWWWWWWWWWW
